R 700 700

NO ./images/brick.xpm
SO ./images/brick.xpm

EA ./images/brick.xpm


S  ./images/small_chest.xpm

WE ./images/grey.xpm

F 200,240,155
C 116,60,237

        1111111111111111111111111
        1000000000110000000000001
        1010000001110000002222001
        1001000000000000002220001
11111111101100000111000002200001
10000000001100000111011111111111
11110111111111011100000010001
1111011111111101110101001200W1
11000000110101011100000010001
100000000000000000000000000011
122220000000000001101010210001
110000011101010111110111100011
11112111 11101011101111010001
11111111 11111111111111111111